======================================================
=S====================================================
=.====================================================
=...................................................E=
======================================================
