====================
=..................=
=..................=
=..................=
=..................=
=..................=
=..................=
=..................=
=S.................=
=E.................=
=..................=
=..................=
=..................=
=..................=
=..................=
=..................=
=..................=
=..................=
=..................=
====================
