====================
=S........==========
=.=======.==========
=.===E....==========
=.=======.==========
=.........==========
====================
====================
====================
====================
====================
====================
====================
====================
====================
====================
====================
====================
====================
====================
