====================
=S=.=.=.=.=.=.=.=.==
=.=.=.=.=.=.=.=.=.==
=.................==
===.=.=.=.=.=.=.=.==
===.=.=.=.=.=.=.=.==
==................==
===.=.=.=.=.=.=.=.==
==................==
===.=.=.=.=.=.=.=.==
=================.==
=================.==
=================.==
==................==
===.=.=.=.=.=.=.=.==
=================.==
=.................==
=.==================
=E==================
====================
