====================
======............S=
=====..=========.===
================.===
=................===
=.==================
=................===
===============.====
===============.====
===============.====
===============.====
===============.====
===.............====
===.===========.====
===.===========..===
===.=====........===
===.=====.==========
===E......==========
====================
====================
