====================
=S........==========
=========.==========
==......=.==========
===.=.=...==========
==..=..=.===========
======.==.==========
======....==========
======.==.==========
======.========..===
======.========.====
=====.............==
======.======.======
=====...=.=====.====
=====.........======
======.=============
======.=============
==E....=============
====================
====================
