====================
=..=.====...========
=..=.===.=.=========
=.==.=====.=========
=...S......=========
=======...==========
=======.============
=.........E=========
====================
====================
====================
====================
====================
====================
====================
====================
====================
====================
====================
====================
